########
#      #
# .@$. #
#   .  #
########
