##########
#        #
# .$$@$. #
#  .  .  #
#        #
##########
