########
#  .   #
# $$@$.#
#  .   #
########
