#############
#           #
# .$ $$@$ $.#
#  .   .  . #
#  $  $ $ $ #
#           #
# .   .  .  #
#           #
#############
